#######################
Eo....#ooooooooo#.#.#.#
#o###.#o#.###.#ooooooo#
#o#...#o#.#.#..#oo###o#
#o#####o#...#.#.#.#.#o#
#oooo#oo.####.#.#...#o#
##.#o#o#.#.#...######o#
#..#ooo#...#.#......#oS
#######################
